11111111111111111111
1E0000CCCCCCCCCCCCC1
111101C1001C000C11C1
1C1C01CC101C101CCCC1
1001001CCC1C00CC11C1
1P0C10001CCC1CC11CC1
101CC110111C1C11CC11
1CC1CCCCCCCCCCCCC111
11111111111111111111



